011111111110
100000000001
100000100001
100N00000001
011111111110