
F 220,100,255
C 220,100,255
NO ./text_n.xpm
SO ./text_s.xpm
WE ./text_w.xpm
EA ./text_e.xpm

111111111111
100000000N01
100000100001
100000000001
111111111111
