F 255,0,255
C 0,0,0
NO ./assets/img/text_n/text_n.xpm
SO ./assets/img/text_s/text_s.xpm
WE ./assets/img/text_w/text_w.xpm
EA ./assets/img/text_e/text_e.xpm

11111111111111111111111111111111111111111111111111
10000000000000000000000000000000000000000000000001
10000000000000000000000000000000000000000000000001
10000000000000000000000000000000000000000000000001
100000000000000000000000000000000000000000100000011
10000000000000000000000000000000E000000001 100000001
100000000000000000000000000000000000000000100000011
10000000000000000000000000000000000000000000000001
11111111111111111111111111111111111111111111111111