   F 220,100,255

C  100,100,100

NO   ./path_to_the_north_texture
SO ./path_to_the_south_texture
WE ./path_to_the_west_texture
EA ./path_to_the_east_texture


 1  11111 1 1
101111111101
100000100011 
111111111111111
  1000N00001000111
1111111111110111
10000000011111
1100011011
1111111011
11111111111
11111
