F 220,100,200
C 220,10h,0
NO ./path_to_the_north_texture
SO ./path_to_the_south_texture
WE ./path_to_the_west_texture
EA ./path_to_the_east_texture

11111    1111
101111111101    11
1000000100011 
11111111111111
  100N00001000111
1111111111110111
10000000011111
1100011011
1111111011
       1
