111111111111
100000000001
100000100001
100N00000001
11111111111