F 220,100,200
C 220,100,0
NO ./path_to_the_north_texture
SO ./path_to_the_south_texture
WE ./path_to_the_west_texture
EA ./path_to_the_east_texture

111111
10011
101001
1100N1
11111