111111
1S0101
101001
110001
111111